1 13 31
###############################
#p     **b*  1 * 2 *  * * *   #
#*# # #*# # #*#*# # # #*#*#*# #
#   *     ** * *  1   * 2 * * #
# # # # # #*# #f#*#*# # # # #*#
#f  ** **  x **  *  *   1     #
# # # #s# # # # # #*# #*# # # #
#*  *      *  *      *        #
# # #b# #*# # # #*#*# # #b# # #
#*    **  *       *           #
# #*# # # # # # #*# # # # # # #
#     2     b*  *  *  1       #
###############################