1 13 31
###############################
#p s*   *** *  *  1 *  * * *  #
# # # #*# # #*#*# # # #*#*#*# #
#*  *  *  **f* *  x 2 *   * * #
# # # # # #*# # #*#*# # # # #*#
#    * * t *  **  *  *  l     #
# # # # # # # # # #*# #*# # # #
#*  * b    *   *      *       #
# # # # #*# # # #*#*# # # # # #
#*    **  *       *      2    #
# #*# # # # # # #*# # # # # # #
#   3  *****  *   *  *   *    #
###############################