1 13 31
###############################
#p    *****           *2 *    #
# #*# # # # # # # # # #*# #*# #
#*  t     *       ***    *    #
# # #*# # # #*#*# #*# # # # # #
#  *   **      *l      **     #
# # # # # # # # # # # # # # # #
#  *  ****b  *  * t  *      * #
#*#*#*#*# # # # # # # # # # # #
#   2      *   *  **f ** *   *#
# # # #*# # # # # # #*# # # # #
#       x     *  *  ***     2 #
###############################