1 13 31
###############################
#p  x *** *    *   *  * * *   #
# # # #*# # #*#*# # # #*#*#*# #
#   *    b***  *  1   *   * * #
# # # # # #*# # #*#*# # # # #*#
#f   t   l **  *  *           #
# # # # # # # # # #*# #*#*#*# #
#*  *       *  *      *      *#
# # # # #*# # # #*#*# # # # # #
#*  1  **  *       *     *   *#
# #*# # # # # # #*# # #*# # # #
#      **  *  *   *  *  1 *  *#
###############################